##############################
#                 #         O#
#   #######   X    #   ###   #
#  # ##   #####    #   #  #  #
#  # ##  #    #     # ##  #  #
#  # #  #     #     ##    X  #
#  # # ###     #   X    XXX  #
#    #   #      #       #    #
#A        #         X        #
##############################